AND	AH N D
AND(2)	AE N D
BUT	B AH T
JACOB	JH EY K AH B
KIRAN	K AY R AH N
NOW	N AW
OF	AH V
ON	AA N
ON(2)	AO N
PETRO	P EH T R OW
PRATHIK	P R AE TH AH K
RIGHT	R AY T
SAY	S EY
WHAT	W AH T
WHAT(2)	HH W AH T
WHICH	W IH CH
WHICH(2)	HH W IH CH
WITH	W IH DH
WITH(2)	W IH TH
WORK	W ER K
